Choices, 10
..........................
..........................
..........................
......_....___............
...../0\..]000[.]\........
....]000[_/000\_/0\.......
..../000==000000000\......
...]0000[-\000/-\000[.....
....\000[.]000[.]000[.....
....]0t0[.]S00[.]000[.....
....]0t0[.]00S[.]000[.....
....]0B0[.]S00[.]000[.....
....]0C0[.]PPS[.]000[.....
....]000[.]SoP[.]0o0[.....
.....---...---...---......
..........................
..........................
..........................