3, 8
...........................
...........................
...........................
...........................
................_____......
........__...._/0tCt0\.....
......./oP\../0000B000[....
......]PPPP[]00000000/.....
......]0000\/0000000/......
......]S000000000000[......
......]SS00/\000000/.......
.......\000\/00000/........
........\00000000/.........
.........\000000/..........
..........------...........
...........................
...........................