...........................
...........................
................_____......
........__...._/00C00\.....
......./o0\../0000B000[....
......]0000[]00000000/.....
......]0000\/0000000/......
......]0000SS0000000[......
......]0000/\000000/.......
.......\000\/00000/........
........\00000000/.........
.........\000000/..........
..........------...........
...........................
...........................