0,2,"w" to drive "A" and "D" to steer,sand is slow,get the ball in the hole!
...................................
...................................
...................................
..........................___......
....____....___....___...]PPP[......
...]t0C0\../00S\../000\../PoP[......
...]t00t0\/0t0S0\/00t00\/BPPP[......
....----\00/---\PP/---\00/---......
.........\/.....\/.....\/..........
...................................
...................................
...................................