Level 0,2,"w" to Drive "A" and "D" to Steer, Sand is Slow, Use Space to Gain Speeeeeeeeeeeed,Space to Drift Also,Get the Ball in the Hole!
...................................................
...................................................
...................................................
..........................................___......
....____....___....____________....___...]PPP[......
...]t0C0\../00S\../000000000000\../000\../PoP[......
...]t00t0\/0t0S0\/000t0000000t00\/00t00\/BPPP[......
....----\00/---\PP/------------\00/---\00/---......
.........\/.....\/..............\/.....\/..........
...................................................
...................................................
...................................................