Zig Zag, 7
......................................................................................................
......................................................................................................
...........___________________________________........................................................
..........]00t00t0000SSSSS000000000T0000000000[.......................................................
..........]0000C00000SSSSS000000000T0000000000[.......................................................
..........]000000000000a00000000000T0000000000[.......................................................
..........]00000B000000a00000a00000T0000a00000[.......................................................
..........]000000000000a00000a00000T0000a00000[.......................................................
..........]000000000000a00000a00000T0000a00000[.......................................................
..........]000000000000a00000a0000000000aPPPPP[.......................................................
..........]000000000000000000a0000000000aPPoPP[.......................................................
..........]000000000000000000a0000000000aPPPPP[.......................................................
...........-----------------------------------........................................................
......................................................................................................
......................................................................................................