...........................
...........................
...........................
.......______..............
......]0C0000\_............
......]00B00000[...........
......]00000000\_..........
.......\000000000[___......
........\000000000o0/......
.........-----------.......
...........................
...........................
...........................