Mirror, 10
......................................................................................................
......................................................................................................
......................................................................................................
..........___......___................................................................................
........./000\..../000\...............................................................................
....0t0./0/-\0\../0/-\0\..............................................................................
......_/0/...\0\/0/...\0\_............................................................................
.....]CBa..t..T00a.....TPo[............................................................................
......-\0\.../0/\0\.../0/-............................................................................
........\0\_/0/..\0\_/0/..............................................................................
.........\000/....\000/...............................................................................
..........---......---................................................................................
......................................................................................................
......................................................................................................
......................................................................................................