1 is Easy, 6, Hold "w" to hit the ball, Use "A" and "D" to steer
..........................
..........................
..........____............
.........]0t0t\...........
.......=.]0CB00\..........
.........]0t00t0\___......
..........\00S0000Po\.....
..........]0000000PPP[....
...........----------.....
..........................
..........................
..........................
..........................
..........................