5, 5 
...................................................
..........______...................................
.........]0t00t0[..................................
.........]00C000\..................................
.........]0000000\.................................
.........]0000B000\...._______________............
.........]000000000\__L0000000000PPPPP[............
.........]SSSSSS00000000000000000PPoPP[............
.........]SSSSSSk\000000000000000PPPPP[............
.........]SSSSSS[.\0000000000000000000[............
.........]00o000[..-------------------.............
..........------...................................
...................................................