9 Trident, 6
......................................................................................................
......................................................................................................
......................................................................................................
......................................................................................................
......................................................................................................
......................................................................................................
......................................................................................................
......................................................................................................
......................................................................................................
......................................................................................................
......................................................................................................
......................................................................................................
......................................................................................................
......................................................................................................
......................................................................................................
........................_____________________.........................................................
.......................]000000SS00000000000ao[........................................................
........................}--------------------.........................................................
........................}.............................................................................
........................}.............................................................................
........................}.............................................................................
..______________________}__________________...........................................................
.]CtBt0000000000000000000000000000000000000[..........................................................
..----------------------}------------------...........................................................
........................}.............................................................................
........................}.............................................................................
........................}.............................................................................
........................}__________________...........................................................
.......................]000000000000000PPPo[..........................................................
........................-------------------...........................................................
......................................................................................................
......................................................................................................
......................................................................................................
......................................................................................................
......................................................................................................
......................................................................................................
......................................................................................................
......................................................................................................
......................................................................................................
......................................................................................................
......................................................................................................
......................................................................................................
......................................................................................................
......................................................................................................
......................................................................................................