7 "Heart", 4
......................................................................................................
........____......____...............................................................................
.......]0t0t\..../PPPP[.............................................................................
.......]00C00\../0PPoP[.............................................................................
.......]000000\/00PPPP[.............................................................................
.......]00B00000000000[.............................................................................
........\000000000000/..............................................................................
.........\0000000000/...............................................................................
..........\00000000/................................................................................
...........\000000/.................................................................................
............------..................................................................................
......................................................................................................
......................................................................................................
......................................................................................................