Flacid, 8
.....................................
.....................................
............____.....................
........___/000S\________............
.......]C0B00/\0000000SSS\...........
.......]t0t00\/00000000000\.........
........---\0000/------\000[........
............----.......]PoP[.........
........................---..........
.....................................