..........................
..........................
...........___............
........../000\...........
.......=.]0CB00\..........
.........]000000\___......
..........\00S0000Po\.....
..........]0000000PPP[....
...........----------.....
..........................