Selector, 0, Level 1, Level 2, Level 3, Level 4, Level 5
..................................
..................................
..................................
..........._..._..._..............
......____/o\_/o\_/o\__...........
.....]CtBt0t0t0t0t0t000[..........
......------\o/-\o/----...........
.............-...-................
..................................
..................................
..................................